0000000000
0111111110
0111111110
0111111110
1111111110
0111111110
0111111110
0111111110
0111111110
0000000000
