0000000000
0111111110
0101111110
0000111110
1111111110
0111111110
0110000010
0111011110
0111111110
0000000000
