0000000000
0101111110
0100000010
0111111010
1111111110
0111000010
0111011110
0111011010
0100000010
0000000000
