00000000000000000000
01110111112111100010
01010010010000100010
01011110010110111110
01000100111100100010
00000100100001111010
00111100100011001000
00100011111110001011
00100010000000111010
11121111111110100010
00001010000010100010
01011011111010100010
01010010000010111110
01010010011110000010
01110110010000001110
00100000012111101010
00111111110010111010
00100000000010000000
01101111111111111110
00000000000000000000
